NO ./assets/wall/brick-1l1.png
EA ./assets/wall/brick-2l2.png
SO ./assets/wall/brick-1d3.png
WE ./assets/wall/brick-2d4.png

F 220,100,0
C 225,30,0

        1111111111111111111111111
        1000000000110000000000001
        1011000001110000000000001
        1001000000000000000000001
111111111011000001110000000000001
10000000001100000111011111D111111
11110111111111011100000010001
11110111111111011101010010001
11000000110101011100001110001
100000000000000011000010DDDD11
1000000000000000110101D0D0001
110000011101010111110111D0N0111
11110111 1110101 1011110DDDD1
11111111 1111111 111111111111
