NO ./path_to_the_north_texture
SO ./path_to_the_south_texture
EA ./path_to_the_east_texture
WE ./path_to_the_west_texture

F 220,100,0
C 225,30,0

        1111111111111111111111111
        1000000000110000100000001
        10110000011dddddd10000001
        10010000000d0000d00000001
1111111110110000011d00E0d00000001
1000000000110000011dddddd1111111
11110111111111011100000010001
11110111111111011101010010001
11000000110101011100010000001
10000000000000001100000011d11
100000000000000011010100d0001
1100000111010101111101111000111
11110111 1110101 101111010001
11111111 1111111 111111111111
