NO ./assets/wall1.png
EA ./assets/wall2.png
WE ./assets/wall3.png
SO ./assets/wall5.png

F 185,148,112
C 137,207,243

        1111111111111111111111111
        1000000000110000010100001
        101100000111000001D100001
        100100000000000N000000001
111111111011000001110000000000001
10000000001100000111011111D111111
11110111111111011100000010001
11110111111111011101010010001
11000000110101011100000000001
10000000000000001100000010001
10000000000000001101010010001
1100000111010101111101111000111
11110111 1110101 101111010001
11111111 1111111 111111111111
