NO ./assets/wall5.png
EA ./assets/wall5.png
WE ./assets/wall5.png
SO ./assets/wall5.png

F 185,148,112
C 137,207,243

1111111111
1001000101
1101101101
1000100001
1110111011
1000000011
1101110111
1000010001
11111111N1
1111111111
