NO ./assets/light-yellow.png
EA ./assets/light.png
WE ./assets/dark-yellow.png
SO ./assets/dark.png

F 185,148,112
C 137,207,243

11111                    11111
 10001                  10001
  10001                10001
   10001              10001
    10001            10001
     10001          10001
      10001        10001
       10001      10001
        10001    10001
         10001  10001
          1000110001
           10000001
           100N0001
           10000001
          1000110001
         10001  10001
        10001    10001
       10001      10001
      10001        10001
     10001          10001
    10001            10001
   10001              10001
  10001                10001
 10001                  10001
11111                    11111
